1131111111
1111111111
1111111111
1111111111
1111211111
1111131111
1111113111
1111131111
1111111111
1111111111