3333333333
3111111113
3121121113
3121121113
3121111113
3121121113
3121121113
3121111113
3111111113
3333333333