1131111111
1111111111
1111111111
1111111111
1211111211
1111131111
1111113111
1111121111
1111111111
1111121111