1111131111
1111111111
11312222w11
1131131111
1131112221
1131131111
1132222111
1131111111
1111111111
1111131111