1111131111
1111111111
1131131111
1131131111
1131111111
1131131111
1131131111
1131111111
1111111111
1111131111